   ## # # #### ### ##########
#   ###################   # #
# ####                # # # #
# ################### # # # #
#                     # # # #
#######    ##  ###### # # # #
#   ##     #          # # # #
# # ## ###### ### ##### # # #
# #    #  ###B          # # #
#   ## ################ # # #
##  ##             #### # # #
### ############## ## # # # #
###             ##    # # # #
###### ######## ####### # # #
###### ####             #   #
A      ######################